Dj Counselling - Gravity Drive
Poly Noir - Padá Hvězda
Ezra Furman - One Hand Free
The Charlatans - We Are Love
Preoccupations - Focus
Spiritual Cramp &  Sharon Van Etten - You'Ve Got My Number
Sophia Kennedy - Imaginary Friend
Lcd Soundsystem - X-Ray Eyes
Zapomělsem - Z Východu Mráz
Tame Impala - End Of Summer
Bright Eyes - 1St World Blues
David Byrne - The Fat Man'S Coming
The Notwist - X-Ray
Jenny Hval - To Be A Rose
Pj Harvey & Tim Phillips - Love Will Tear Us Apart
Dry Cleaning - Hit My Head All Day
The Last Shadow Puppets - Pattern
Ride - Last Frontier
Mono - The Remains Of The Day
Russian Circles - Tupilak
Boris - Last Christmas
Rudovous - Lodivodi
Ruce Naší Dory - Pevnostní Netopýr
Květy - Kámoši
Otk - Nádoba Na Maso
Www Neurobeat - Žena Líže Kost
Emma Ruth Rundle - Citadel
Mark Lanegan - Ketamine
Arab Strap - Bliss
Chelsea Wolfe - Unseen World
Low - No End
Lykke Li - I Follow Rivers
Cate Le Bon - Pompeii
The Kills - Going To Heaven
Nick Cave & The Bad Seeds - Mercy Seat (Video Mix)
Zivotveteru.Cz - Historie Radia 1 - Taky V Obchodech
Bird Of Peace Orchestra - Plain Clothes
Beachers - Pursuit
Sir Robert Orange Peel - A Man Dressed Up
Bob Dylan - Do You Hear What I Hear
Wreckless Eric - Playtime Is Over
Willie Nelson - Pretty Paper
Teho Teardo - Difficolta Con Il Rosso
Durutti Column - I Am A Face
Soul Coughing - Shakedown Dub
Ken Ishii, Dj Spooky - Enso Online
Ikonika - Make It Better
Propellerheads Ft Ms Shirley Bassey - History Repeating
John Zorn, Mike Patton - Let It Snow
Django Reinhardt, Michelmwarlop - Christmas Swing
Mel Tormé - The Christmas Sog - Sonny J Remix
Mark Lanegan - Down In Yon Forest
Eraldo Bernocchi, Merzbow, Iggor Cavalera - Swietenia Macrophylla
The Bug - Burial Skank - Mass, Brixton
Martha Da Ro - Pretty Ugly
Midwife - No Depression In Heaven
Vu - Lady Godivas Operation
Brent Vanneste - Dark Thoughts At Midnight
Litronix - Vitamin L
Eat-Girls - Off The
Getdown Services - Chrysalis
Sextile - Soggy Newports
David Holmes - Love Reign Over Me
Herbert, Momoko Gil - More And More
Unloved - Accountable Ft Jarvis Cocker
Zonbi - Lanmou Ak Lanmo
Big Special - Thin Horses
Martin Gore - Smile In The Crowd - Cover
Martyn Lenoble - Cat People (Putting Out Fire)  Ft Dave Gahan, Mark Lanegan
The Young God - Did You Miss Me - Live Montreux - Ft Mike Patton
Sun Kil Moon, Amoeba - Wolves
Sandwell District - The Silent Servant
Olan Monk - Down 3
Television - 1880 Or So
Animal Collective - Boardwalk
Tunde Adebimpe - Streetlight Nuevo
Quade - Beckett
Bob Dylan - Hark The Herald Angels Sing
Charanjit Singh - Chahoonga Main Tujhe
Getdown Services, Mumble Tide - Dont Talk
Ken Boothe, Jah Wobble - Is It Because Im Black
Domenique Dumont - People On Sunday
Nabihah Iqbal - This World Couldnt See Us
Soft Kill - Pretty Face
New Order - Guilty Partner
Disinblud, Rachika Nayar - Serpentine - The Field Remix
Alan Vega - Ice Drummer
Martin Rev - Temptation
Rowland S Howard - Pop Crimes
The Fall - Chicago Now
Ramones - Merry Christmas
Steven Severin - Aetiology Of The Irreal
Heems, Lee Ranaldo - Nothing Good Is Easy
Julian Casablancas - I Wish It Was Christmas Today
Zonbi - Dife
Party Dozen - Ghost Rider
Morphine - The Saddest Song
Jimmy Cliff - Sitting In Limbo
Litronix - Bus Stop - Beak Remix
Soul Coughing - Sugar Free Jazz - Mad Professor Remix
Holy Tongue - I Am Here In A Place Beyond...
Thee Sacred Souls - Future Lover
Zentone, Zenzile, Hightone - Stone Cold Dub
Pot-Pot - 22 Halo
Slackwax - Wandering Lo
Kiyoaki Iwamoto - Love Will Tear Us Apart - Cover
Go Kurosawa - Autowalk
Lael Neale - Every Star Shivers In The Dark
Nick Cave - Hallelujah
The National - Lemonworld
Hugo Race + Michelangelo Russo - Lost Children
Dean And Britta, Sonic Boom - Stille Nacht
Arab Strap - Turn Off The Light
Sparklehorse - Everybodys Gone To Sleep
Divide And Kreate - Santatage - Beastie Boys/Otis Redding Mashup
Mute Swan Feat Stacie Huttleson - Cocteau Swan
Softcult - Queen Of Nothing
Keep Shelly In Athems - Better Said
Sword Ii - Sentry
The Afghan Wigs - Fake Like
Jaded Juice Riders - Already Christmas
Makthaverskan - Piti Party
Ratboys - What'S Right
Bibiza - Maschinenraum
The Divine Comedy - Come Home Billy Bird
Bush - Cold Contagious
The Horrors - Something To Remember Me By
U2 - The Fly
New Radicals - You Get What You Give
Weezer - Island In The Sun
Turntablerocker - No Melody
Way Out West - Ajare
Taithless - God Is My Dj
Der Dritte Raum - Trommelmaschine
Tata Bojs - Třetí Osoba
Terra & Kewu - No
Horkýže Slíže - Malá Žužu
Cocot Minutte - Můj Čas
Jolly Joker - Ghostbusters
Sebastiens - Zavolejte Stráže
Mňága A Žďorp - Hodinový Hotel
Sluníčko - Zmrzlá Husa
Alien Vampires - I Fuck Nuns
Ministry - The Land Of Rape And Honey
Killing Joke - Democracy
Temples - Gamma Rays
Spirit Of The Beehive - I´Ve Been Evil
Special Interest - Nothing Grows Here
The Beaches - Grow Up Tomorrow
Peter Bjorn & John - Young Folks
Fontaines D.C. - It´S Amazing To Be Young
Cold Cold Nights - No New Texts
Decline - Sleepless
The Big Tusk - Bad Mammuth
The Bad Plus - Super America
Dry Cleaning - Don´T Press Me
10 - 11
Sleight Bells - And Saints
Beach Bunny - Christmas Caller
Vampire Weekend - A-Punk
Pictureplane - Heaven Is A State Of Mind
Depeche Mode - Walking In My Shoes
Sarah Vaughan - Stormy Weather
Ray Charles - Over The Rainbow
Julee Cruise - The World Spins
Frank Zappa - My Guitar Wants To Kill Your Mama
David Bowie - Suffragette City
Focus - Hocus Pocus
Alex G - Blessing
Ladytron - The Night
11 - 12
L.S.Dunes - Machines
Algiers - I Can´T Stand It!
Facs - You Future
The Stranglers - All Day And All Of The Night
The Damned - Neat Neat Neat
The Ramones - Merry Christmas (I Don´T Want To Fight Tonight)
Sonic Youth - Superstar
Carole King - It´S Too Late
Bill Justis - Raunchy
Ricky Nelson - Simmertime
Garáž - Houby
Tenpole Tudor - Swords Of A Thousand Man
Ian Dury And The Blockheads - Sex & Drugs & Rock & Roll
15 - 16
Leftfield - Melt
Biig Piig - Decimal
Alewya Ft. Dagmawit Ameha - Night Drive
Booka Shade - Broken Glass
The Orb - It'S Coming Soon
Luttrell - Something Right (Super Flu Rmx)
M83 - Reunion (The Naked And Famous Rmx)
Oliver Torr & Survival Course - Nekk
Terezie Kovalová - Orfeus
Infinite Coles - Sweetfacekillah
Transglobal Underground - Temple Head
Maribou State Ft. Andreya Triana - All I Need
16 - 17
Wet Leg - Mangetout
Darkside - S.N.C.
Beach Fossils - Inside Out
The Horrors - La Runaway
Jakub Koning - Astronauti
Kyšperský, Doubrava, Pilgr, Nikl - Cit
Daniel Avery & Cecile Believe - Rapture In Blue
Tame Impala - My Old Ways
The Crying Nudes - Joyride
Curve - Doppelganger
17 - 18
---- Rozhovor - Výstava Dvojník V Ghmp Zvon----
Rosalía - Dios Es Un Stalker
Matt Berninger - Bonnet Of Pins
Anna Calvi & Perfume Genius - I See A Darkness
Bone Constructor Ft. Charlie One - Save The Bees
Agstashe - On Off
Sophie So - Do Me A Favour
Apparat - An Echo Skips My Name (Alterneate Take)
The Sabres Of Paradise - Smokebelch Ii (Beatless Mix)
Run Dmc - Christmas In Hollis
Swarms - Black Chapel Sun
Dinosaur Jr. - In A Jar
Fugazi - Give Me The Cure
Beastie Boys - No Sleep Till Brooklyn
Nena - Irgenwie, Irgendwo, Irgendwann
Kate Bush - Cloudbusting
Sonic Youth - Silver Rocket
Talking Heads - This Must Be The Place (Naive Melody)
Peter Gabriel - Mercy Street
Paul Simon - The Boy In The Bubble
Beat Happening - Indian Summer
Daniel Johnston - Walking The Cow
Pixies - Wave Of Mutilation - Uk Surf
Sinéad O'Connor - Drink Before The War
U2 - Exit
Snocaps - Wasteland
Mou - On Our Own
Saint Jude - Desire
Snuggle - Sun Tan
Brian Bilston, The Catenary Wires - Every Song On The Radio Reminds Me Of You
Sex Mask - Girth
Yumi Zouma - Phoebe'S Song
Fade Evare - Sky Writing
Acopia - Be Enough
Sassy 009, Blood Orange - Tell Me
Geese - Taxes
Ceci - Rage
Illuminati Hotties - Post-Everything
Clothesline From Hell - Truest Sound
Elias Ronnenfelt - The Orchids
Boygenius - Not Strong Enough
Mou - Don'T Be Another One Waiting
Saint Jude, Taxi For Kaye - Hopeful
Ocún - Poslední Sezóna
Market - Cups
Buchty / Nouze - Bachno
Mat213 - I Dont Wanna Go To War But I Could
Anna Vaverková - Čas 2.0
Athena Chlebová - Párky Na Splátky (Ft. Strýc Nory)
